wasnt	big
thats	lot
ive	upset
coming	audience
porn	ever
get	used
every	year
pound	ok
second	clean
exact	words
knowing	youre
cant	live
sized	aortic
uh	kind
yes	love
got	first
got	chance
knows	monica
sure	get
likes	women
get	everything
anything	dont
together	rest
dont	problem
sometimes	like
janice	hey
one	gives
wrong	guy
believe	monicas
yknow	already
wooden	boy
give	second
monicas	face
like	joey
us	couple
eight	hours
worry	ill
things	gon
little	late
shes	backing
theres	nuclear
hear	ya
going	inseam
lying	around
going	spring
na	want
big	white
wed	appreciate
stuff	wouldnt
got	wrong
thing	matters
see	scalp
got	ross
away	whole
wasnt	trying
three	guys
looking	upside
know	jewelry
told	talented
nobody	else
wont	know
together	understand
sorry	really
well	big
couldnt	sleep
somebodys	gon
weird	like
aw	ow
girl	seeing
im	see
dennis	thanks
anything	different
thankful	thanksgivings
candy	cookie
finally	able
bye	take
et	rachel
try	find
cover	connecticut
ive	really
oh	said
good	get
mean	didnt
get	talk
let	think
ross	sports
thirty	year
able	make
destroy	universe
like	hundred
house	crap
ever	thought
iloveher	love
ok	good
could	worse
number	number
great	catch
dont	touch
problem	opening
think	first
